data,stato,codice_regione,denominazione_regione,lat,long,ricoverati_con_sintomi,terapia_intensiva,totale_ospedalizzati,isolamento_domiciliare,totale_positivi,variazione_totale_positivi,nuovi_positivi,dimessi_guariti,deceduti,totale_casi,tamponi,casi_testati,note_it,note_en
2020-04-10T17:00:00,ITA,13,Abruzzo,42.35122196,13.39843823,305,53,358,1277,1635,69,83,181,198,2014,18088,,,
2020-04-10T17:00:00,ITA,17,Basilicata,40.63947052,15.80514834,59,15,74,205,279,4,5,14,15,308,3696,,,
2020-04-10T17:00:00,ITA,21,P.A. Bolzano,46.49933453,11.35662422,258,58,316,1001,1317,2,52,447,191,1955,20866,,,
2020-04-10T17:00:00,ITA,18,Calabria,38.90597598,16.59440194,168,14,182,604,786,21,27,50,65,901,16637,,,
2020-04-10T17:00:00,ITA,15,Campania,40.83956555,14.25084984,600,90,690,2273,2963,90,98,248,231,3442,31745,,,
2020-04-10T17:00:00,ITA,08,Emilia-Romagna,44.49436681,11.3417208,3596,349,3945,9405,13350,92,451,3381,2397,19128,85884,,,
2020-04-10T17:00:00,ITA,06,Friuli Venezia Giulia,45.6494354,13.76813649,167,33,200,1198,1398,8,50,772,179,2349,28097,,,
2020-04-10T17:00:00,ITA,12,Lazio,41.89277044,12.48366722,1236,201,1437,2196,3633,101,154,687,263,4583,61769,,,
2020-04-10T17:00:00,ITA,07,Liguria,44.41149315,8.9326992,1076,151,1227,2074,3301,48,171,1181,709,5191,19514,,,
2020-04-10T17:00:00,ITA,03,Lombardia,45.46679409,9.190347404,11877,1202,13079,16451,29530,456,1246,16280,10238,56048,186325,,,
2020-04-10T17:00:00,ITA,11,Marche,43.61675973,13.5188753,925,127,1052,2264,3316,-85,129,1086,682,5084,18970,,,
2020-04-10T17:00:00,ITA,14,Molise,41.55774754,14.65916051,28,4,32,161,193,4,9,37,13,243,2069,,pd-IT-0010,pd-EN-0010
2020-04-10T17:00:00,ITA,01,Piemonte,45.0732745,7.680687483,3497,394,3891,7685,11576,240,490,1904,1532,15012,57457,,,
2020-04-10T17:00:00,ITA,16,Puglia,41.12559576,16.86736689,631,80,711,1625,2336,35,93,235,238,2809,27812,,,
2020-04-10T17:00:00,ITA,20,Sardegna,39.21531192,9.110616306,107,26,133,743,876,0,37,118,69,1063,9444,,,
2020-04-10T17:00:00,ITA,19,Sicilia,38.11569725,13.3623567,568,62,630,1337,1967,25,70,187,148,2302,31156,,,
2020-04-10T17:00:00,ITA,09,Toscana,43.76923077,11.25588885,1011,256,1267,4555,5822,119,175,451,454,6727,72001,,,
2020-04-10T17:00:00,ITA,22,P.A. Trento,46.06893511,11.12123097,335,70,405,1589,1994,16,108,547,275,2816,14981,,,
2020-04-10T17:00:00,ITA,10,Umbria,43.10675841,12.38824698,146,39,185,567,752,-40,4,498,52,1302,16325,,,
2020-04-10T17:00:00,ITA,02,Valle d'Aosta,45.73750286,7.320149366,131,16,147,455,602,-7,11,170,107,879,3328,,,
2020-04-10T17:00:00,ITA,05,Veneto,45.43490485,12.33845213,1521,257,1778,8869,10647,198,488,1981,793,13421,180700,,,
