data,stato,codice_regione,denominazione_regione,lat,long,ricoverati_con_sintomi,terapia_intensiva,totale_ospedalizzati,isolamento_domiciliare,totale_positivi,variazione_totale_positivi,nuovi_positivi,dimessi_guariti,deceduti,totale_casi,tamponi,casi_testati,note_it,note_en
2020-05-09T17:00:00,ITA,13,Abruzzo,42.35122196,13.39843823,246,10,256,1420,1676,-37,8,1055,355,3086,47190,33013,,
2020-05-09T17:00:00,ITA,17,Basilicata,40.63947052,15.80514834,45,1,46,99,145,-7,0,210,27,382,17433,16941,,
2020-05-09T17:00:00,ITA,21,P.A. Bolzano,46.49933453,11.35662422,55,9,64,409,473,-29,9,1804,290,2567,48858,21969,,
2020-05-09T17:00:00,ITA,18,Calabria,38.90597598,16.59440194,68,2,70,542,612,-7,3,427,90,1129,45071,42993,,
2020-05-09T17:00:00,ITA,15,Campania,40.83956555,14.25084984,415,26,441,1524,1965,-47,14,2223,388,4576,110811,52593,,
2020-05-09T17:00:00,ITA,08,Emilia-Romagna,44.49436681,11.3417208,1604,155,1759,5642,7401,-329,121,15491,3827,26719,227366,146642,,
2020-05-09T17:00:00,ITA,06,Friuli Venezia Giulia,45.6494354,13.76813649,101,3,104,765,869,-42,8,1947,308,3124,88384,55319,,
2020-05-09T17:00:00,ITA,12,Lazio,41.89277044,12.48366722,1277,82,1359,2986,4345,17,47,2235,553,7133,174448,137428,,
2020-05-09T17:00:00,ITA,07,Liguria,44.41149315,8.9326992,501,42,543,2439,2982,-194,15,4480,1276,8738,64926,39600,,
2020-05-09T17:00:00,ITA,03,Lombardia,45.46679409,9.190347404,5535,330,5865,24397,30262,-1721,502,36039,14924,81225,477765,282817,,
2020-05-09T17:00:00,ITA,11,Marche,43.61675973,13.5188753,285,32,317,2913,3230,-8,23,2305,958,6493,73965,47827,,
2020-05-09T17:00:00,ITA,14,Molise,41.55774754,14.65916051,8,0,8,197,205,21,20,120,22,347,8691,8375,,
2020-05-09T17:00:00,ITA,01,Piemonte,45.0732745,7.680687483,2010,143,2153,11781,13934,-173,181,11284,3331,28549,205800,141515,,
2020-05-09T17:00:00,ITA,16,Puglia,41.12559576,16.86736689,344,33,377,2352,2729,-4,30,1114,443,4286,76643,54181,,
2020-05-09T17:00:00,ITA,20,Sardegna,39.21531192,9.110616306,87,11,98,452,550,-3,4,665,119,1334,33330,29503,,
2020-05-09T17:00:00,ITA,19,Sicilia,38.11569725,13.3623567,277,17,294,1786,2080,-47,12,977,256,3313,101548,90885,,
2020-05-09T17:00:00,ITA,09,Toscana,43.76923077,11.25588885,364,79,443,4005,4448,-144,24,4360,937,9745,174596,129382,,
2020-05-09T17:00:00,ITA,22,P.A. Trento,46.06893511,11.12123097,87,10,97,733,830,-42,7,3024,438,4292,50278,30354,,
2020-05-09T17:00:00,ITA,10,Umbria,43.10675841,12.38824698,45,6,51,60,111,-8,1,1225,71,1407,45574,31679,,
2020-05-09T17:00:00,ITA,02,Valle d'Aosta,45.73750286,7.320149366,45,3,48,70,118,-5,1,895,139,1152,9443,7130,,
2020-05-09T17:00:00,ITA,05,Veneto,45.43490485,12.33845213,435,40,475,5402,5877,-310,53,11151,1643,18671,432114,244930,,
