data,stato,codice_regione,denominazione_regione,lat,long,ricoverati_con_sintomi,terapia_intensiva,totale_ospedalizzati,isolamento_domiciliare,totale_positivi,variazione_totale_positivi,nuovi_positivi,dimessi_guariti,deceduti,totale_casi,tamponi,casi_testati,note_it,note_en
2020-05-07T17:00:00,ITA,13,Abruzzo,42.35122196,13.39843823,263,12,275,1495,1770,-21,25,954,348,3072,45021,32186,,
2020-05-07T17:00:00,ITA,17,Basilicata,40.63947052,15.80514834,48,2,50,105,155,-17,-16,202,26,383,16272,15780,dc-IT-0022,dc-EN-0022
2020-05-07T17:00:00,ITA,21,P.A. Bolzano,46.49933453,11.35662422,87,11,98,453,551,-28,9,1715,286,2552,47091,21284,,
2020-05-07T17:00:00,ITA,18,Calabria,38.90597598,16.59440194,81,2,83,550,633,-11,3,403,89,1125,42854,40806,,
2020-05-07T17:00:00,ITA,15,Campania,40.83956555,14.25084984,415,27,442,1697,2139,-201,9,2023,379,4541,101025,50463,,
2020-05-07T17:00:00,ITA,08,Emilia-Romagna,44.49436681,11.3417208,1726,173,1899,6112,8011,-380,108,14710,3766,26487,217039,141468,,
2020-05-07T17:00:00,ITA,06,Friuli Venezia Giulia,45.6494354,13.76813649,109,2,111,816,927,-35,13,1872,308,3107,82012,51123,,
2020-05-07T17:00:00,ITA,12,Lazio,41.89277044,12.48366722,1291,89,1380,2968,4348,-85,39,2143,543,7034,165340,130351,,
2020-05-07T17:00:00,ITA,07,Liguria,44.41149315,8.9326992,525,57,582,2666,3248,-58,94,4143,1254,8645,61446,38071,,
2020-05-07T17:00:00,ITA,03,Lombardia,45.46679409,9.190347404,5848,480,6328,25687,32015,262,720,33329,14745,80089,455294,262964,,
2020-05-07T17:00:00,ITA,11,Marche,43.61675973,13.5188753,328,41,369,2878,3247,11,31,2257,948,6452,71017,46258,,
2020-05-07T17:00:00,ITA,14,Molise,41.55774754,14.65916051,8,0,8,162,170,-9,1,113,22,305,8237,7912,,
2020-05-07T17:00:00,ITA,01,Piemonte,45.0732745,7.680687483,2147,150,2297,12172,14469,-389,196,10384,3282,28135,194584,134567,,
2020-05-07T17:00:00,ITA,16,Puglia,41.12559576,16.86736689,355,35,390,2410,2800,-103,49,1004,441,4245,72796,51638,,
2020-05-07T17:00:00,ITA,20,Sardegna,39.21531192,9.110616306,90,9,99,484,583,-40,5,622,119,1324,31064,27540,,
2020-05-07T17:00:00,ITA,19,Sicilia,38.11569725,13.3623567,349,21,370,1757,2127,-74,7,910,251,3288,95695,85674,,
2020-05-07T17:00:00,ITA,09,Toscana,43.76923077,11.25588885,437,91,528,4188,4716,-372,26,4052,915,9683,166062,124295,,
2020-05-07T17:00:00,ITA,22,P.A. Trento,46.06893511,11.12123097,99,11,110,800,910,-72,3,2935,438,4283,46500,28486,,
2020-05-07T17:00:00,ITA,10,Umbria,43.10675841,12.38824698,47,9,56,85,141,-30,1,1194,70,1405,42788,29708,,
2020-05-07T17:00:00,ITA,02,Valle d'Aosta,45.73750286,7.320149366,49,2,51,79,130,3,4,881,139,1150,8939,6702,,
2020-05-07T17:00:00,ITA,05,Veneto,45.43490485,12.33845213,872,87,959,5575,6534,-255,74,10430,1589,18553,410212,236281,,
